# prefixes

hundred = 1e2
thousand = 1e3
million = 1e6
billion = 1e9
trillion = 1e12
quadrillion = 1e15


# mass

kt = 1e6 * kilogram
tonnes = 1000 kilogram


# transport

tkm = tonne * kilometer


# currency

AFN = [currency] = Afghani
ALL = [currency] = Lek
DZD = [currency] = Algerian_Dinar
USD = [currency] = US_Dollar
EUR = [currency] = Euro
AOA = [currency] = Kwanza
XCD = [currency] = East_Caribbean_Dollar
ARS = [currency] = Argentine_Peso
AMD = [currency] = Armenian_Dram
AWG = [currency] = Aruban_Florin
AUD = [currency] = Australian_Dollar
AZN = [currency] = Azerbaijan_Manat
BSD = [currency] = Bahamian_Dollar
BHD = [currency] = Bahraini_Dinar
BDT = [currency] = Taka
BBD = [currency] = Barbados_Dollar
BYR = [currency] = Belarusian_Ruble_2001
BYN = [currency] = Belarusian_Ruble_2017
BZD = [currency] = Belize_Dollar
XOF = [currency] = CFA_Franc_BCEAO
BMD = [currency] = Bermudian_Dollar
INR = [currency] = Indian_Rupee
BTN = [currency] = Ngultrum
BOB = [currency] = Boliviano
BOV = [currency] = Mvdol
BAM = [currency] = Convertible_Mark
BWP = [currency] = Pula
NOK = [currency] = Norwegian_Krone
BRL = [currency] = Brazilian_Real
BND = [currency] = Brunei_Dollar
BGN = [currency] = Bulgarian_Lev
BIF = [currency] = Burundi_Franc
CVE = [currency] = Cabo_Verde_Escudo
KHR = [currency] = Riel
XAF = [currency] = CFA_Franc_BEAC
CAD = [currency] = Canadian_Dollar
KYD = [currency] = Cayman_Islands_Dollar
CLP = [currency] = Chilean_Peso
CLF = [currency] = Unidad_de_Fomento
CNY = [currency] = Yuan_Renminbi
COP = [currency] = Colombian_Peso
COU = [currency] = Unidad_de_Valor_Real
KMF = [currency] = Comorian_Franc
CDF = [currency] = Congolese_Franc
NZD = [currency] = New_Zealand_Dollar
CRC = [currency] = Costa_Rican_Colon
HRK = [currency] = Croatian_Kuna
CUC = [currency] = Peso_Convertible
CUP = [currency] = Cuban_Peso
ANG = [currency] = Netherlands_Antillean_Guilder
XCG = [currency] = Caribbean_Guilder
CZK = [currency] = Czech_Koruna
DKK = [currency] = Danish_Krone
DJF = [currency] = Djibouti_Franc
DOP = [currency] = Dominican_Peso
EGP = [currency] = Egyptian_Pound
SVC = [currency] = El_Salvador_Colon
ERN = [currency] = Nakfa
SZL = [currency] = Lilangeni
ETB = [currency] = Ethiopian_Birr
FKP = [currency] = Falkland_Islands_Pound
FJD = [currency] = Fiji_Dollar
XPF = [currency] = CFP_Franc
GMD = [currency] = Dalasi
GEL = [currency] = Lari
GHS = [currency] = Ghana_Cedi
GIP = [currency] = Gibraltar_Pound
GTQ = [currency] = Quetzal
GBP = [currency] = Pound_Sterling
GNF = [currency] = Guinean_Franc
GYD = [currency] = Guyana_Dollar
HTG = [currency] = Gourde
HNL = [currency] = Lempira
HKD = [currency] = Hong_Kong_Dollar
HUF = [currency] = Forint
ISK = [currency] = Iceland_Krona
IDR = [currency] = Rupiah
IRR = [currency] = Iranian_Rial
IQD = [currency] = Iraqi_Dinar
ILS = [currency] = New_Israeli_Sheqel
JMD = [currency] = Jamaican_Dollar
JPY = [currency] = Yen
JOD = [currency] = Jordanian_Dinar
KZT = [currency] = Tenge
KES = [currency] = Kenyan_Shilling
KPW = [currency] = North_Korean_Won
KRW = [currency] = Won
KWD = [currency] = Kuwaiti_Dinar
KGS = [currency] = Som
LAK = [currency] = Lao_Kip
LBP = [currency] = Lebanese_Pound
LSL = [currency] = Loti
ZAR = [currency] = Rand
LRD = [currency] = Liberian_Dollar
LYD = [currency] = Libyan_Dinar
CHF = [currency] = Swiss_Franc
MOP = [currency] = Pataca
MGA = [currency] = Malagasy_Ariary
MWK = [currency] = Kwacha
MYR = [currency] = Malaysian_Ringgit
MVR = [currency] = Rufiyaa
MRO = [currency] = Ouguiya_1970
MRU = [currency] = Ouguiya_2017
MUR = [currency] = Mauritius_Rupee
MXN = [currency] = Mexican_Peso
MXV = [currency] = Mexican_Unidad_de_Inversion
MDL = [currency] = Moldovan_Leu
MNT = [currency] = Tugrik
MAD = [currency] = Moroccan_Dirham
MZN = [currency] = Mozambique_Metical
MMK = [currency] = Kyat
NAD = [currency] = Namibia_Dollar
NPR = [currency] = Nepalese_Rupee
NIO = [currency] = Cordoba_Oro
NGN = [currency] = Naira
MKD = [currency] = Denar
OMR = [currency] = Rial_Omani
PKR = [currency] = Pakistan_Rupee
PAB = [currency] = Balboa
PGK = [currency] = Kina
PYG = [currency] = Guarani
PEN = [currency] = Nuevo_Sol
PHP = [currency] = Philippine_Peso
PLN = [currency] = Zloty
QAR = [currency] = Qatari_Rial
RON = [currency] = New_Romanian_Leu
RUB = [currency] = Russian_Ruble
RWF = [currency] = Rwanda_Franc
SHP = [currency] = Saint_Helena_Pound
WST = [currency] = Tala
STD = [currency] = Dobra_1970
STN = [currency] = Dobra_2017
SAR = [currency] = Saudi_Riyal
RSD = [currency] = Serbian_Dinar
SCR = [currency] = Seychelles_Rupee
SLL = [currency] = Leone_1970
SLE = [currency] = Leone_2023
SGD = [currency] = Singapore_Dollar
SBD = [currency] = Solomon_Islands_Dollar
SOS = [currency] = Somali_Shilling
SSP = [currency] = South_Sudanese_Pound
LKR = [currency] = Sri_Lanka_Rupee
SDG = [currency] = Sudanese_Pound
SRD = [currency] = Surinam_Dollar
SEK = [currency] = Swedish_Krona
CHE = [currency] = WIR_Euro
CHW = [currency] = WIR_Franc
SYP = [currency] = Syrian_Pound
TWD = [currency] = New_Taiwan_Dollar
TJS = [currency] = Somoni
TZS = [currency] = Tanzanian_Shilling
THB = [currency] = Baht
TOP = [currency] = Paanga
TTD = [currency] = Trinidad_and_Tobago_Dollar
TND = [currency] = Tunisian_Dinar
TMT = [currency] = Turkmenistan_New_Manat
TRY = [currency] = New_Turkish_Lira
UGX = [currency] = Uganda_Shilling
UAH = [currency] = Hryvnia
AED = [currency] = UAE_Dirham
UYU = [currency] = Peso_Uruguayo
UYI = [currency] = Uruguay_Peso_en_Unidades_Indexadas
UYW = [currency] = Unidad_Previsional
UZS = [currency] = Uzbekistan_Sum
VUV = [currency] = Vatu
VEF = [currency] = Bolivar_Fuerte
VES = [currency] = Bolivar_Soberano_2018
VED = [currency] = Bolivar_Soberano_2021
VND = [currency] = Dong
YER = [currency] = Yemeni_Rial
ZMW = [currency] = Zambian_Kwacha
ZWL = [currency] = Zimbabwe_Dollar
ZWG = [currency] = Zimbabwe_Gold


Meuro = 1e6 * EUR