[console_scripts]
fromager = fromager.__main__:invoke_main

[fromager.cli]
bootstrap = fromager.commands.bootstrap:bootstrap
bootstrap-parallel = fromager.commands.bootstrap:bootstrap_parallel
build = fromager.commands.build:build
build-order = fromager.commands.build_order:build_order
build-parallel = fromager.commands.build:build_parallel
build-sequence = fromager.commands.build:build_sequence
canonicalize = fromager.commands.canonicalize:canonicalize
download-sequence = fromager.commands.download_sequence:download_sequence
find-updates = fromager.commands.find_updates:find_updates
graph = fromager.commands.graph:graph
lint = fromager.commands.lint:lint
lint-requirements = fromager.commands.lint_requirements:lint_requirements
list-overrides = fromager.commands.list_overrides:list_overrides
list-versions = fromager.commands.list_versions:list_versions
migrate-config = fromager.commands.migrate_config:migrate_config
minimize = fromager.commands.minimize:minimize
stats = fromager.commands.stats:stats
step = fromager.commands.step:step
wheel-server = fromager.commands.server:wheel_server

[fromager.override_methods]
build_sdist = fromager.sources:default_build_sdist
build_wheel = fromager.wheels:default_build_wheel
download_source = fromager.sources:default_download_source
get_build_backend_dependencies = fromager.dependencies:default_get_build_backend_dependencies
get_build_sdist_dependencies = fromager.dependencies:default_get_build_sdist_dependencies
get_build_system_dependencies = fromager.dependencies:default_get_build_system_dependencies
resolve_source = fromager.sources:default_resolve_source
resolver_provider = fromager.resolver:default_resolver_provider
